9 16
################
#E.............#
#####.#######.##
#......#...#...#
#.##.#.#..##.#.#
#..#.#.#.....#.#
####.#########.#
#.....T#.......#
################







