9 16
################
#..............#
#.####.#.####.##
#....#.#..#....#
#.####.#.##.##.#
#....#.#..#NT#.#
#.####.#.#####.#
#........#.....#
################







